WorldTimeAPIResult	KEYWORD1
timezone	KEYWORD2
abbreviation	KEYWORD2
client_ip	KEYWORD2
datetime	KEYWORD2
httpCode	KEYWORD2
error	KEYWORD2
hasError	KEYWORD2
clear	KEYWORD2
toTimeZoneInfo	KEYWORD2

WorldTimeAPI	KEYWORD1
getListOfTimeZones	KEYWORD2
getByTimeZone	KEYWORD2
getByIP	KEYWORD2
getLastResult	KEYWORD2

WorldTimeAPI_HttpCode	KEYWORD1
WTA_ERROR_PARTIAL_TIMEZONE	LITERAL1
WTA_ERROR_ARGUMENT_ERROR	LITERAL1
WTA_ERROR_FIELD_DOUBLE	LITERAL1
WTA_ERROR_FIELD_MISSING	LITERAL1
WTA_ERROR_WRONG_VALUE_FORMAT	LITERAL1
WTA_ERROR_VALUE_OUT_OF_RANGE	LITERAL1
WTA_ERROR_WRONG_VALUE_TYPE	LITERAL1
WTA_ERROR_WRONG_RESPONSE	LITERAL1
WTA_ERROR_ERROR_RESPONSE	LITERAL1

WTA_HTTP_ERROR_CONNECTION_FAILED	LITERAL1
WTA_HTTP_ERROR_SEND_HEADER_FAILED	LITERAL1
WTA_HTTP_ERROR_SEND_PAYLOAD_FAILED	LITERAL1
WTA_HTTP_ERROR_NOT_CONNECTED	LITERAL1
WTA_HTTP_ERROR_CONNECTION_LOST	LITERAL1
WTA_HTTP_ERROR_NO_STREAM	LITERAL1
WTA_HTTP_ERROR_NO_HTTP_SERVER	LITERAL1
WTA_HTTP_ERROR_TOO_LESS_RAM	LITERAL1
WTA_HTTP_ERROR_ENCODING	LITERAL1
WTA_HTTP_ERROR_STREAM_WRITE	LITERAL1
WTA_HTTP_ERROR_READ_TIMEOUT	LITERAL1

WTA_HTTP_NO_CODE	LITERAL1
WTA_HTTP_CODE_CONTINUE	LITERAL1
WTA_HTTP_CODE_SWITCHING_PROTOCOLS	LITERAL1
WTA_HTTP_CODE_PROCESSING	LITERAL1
WTA_HTTP_CODE_OK	LITERAL1
WTA_HTTP_CODE_CREATED	LITERAL1
WTA_HTTP_CODE_ACCEPTED	LITERAL1
WTA_HTTP_CODE_NON_AUTHORITATIVE_INFORMATION	LITERAL1
WTA_HTTP_CODE_NO_CONTENT	LITERAL1
WTA_HTTP_CODE_RESET_CONTENT	LITERAL1
WTA_HTTP_CODE_PARTIAL_CONTENT	LITERAL1
WTA_HTTP_CODE_MULTI_STATUS	LITERAL1
WTA_HTTP_CODE_ALREADY_REPORTED	LITERAL1
WTA_HTTP_CODE_IM_USED	LITERAL1
WTA_HTTP_CODE_MULTIPLE_CHOICES	LITERAL1
WTA_HTTP_CODE_MOVED_PERMANENTLY	LITERAL1
WTA_HTTP_CODE_FOUND	LITERAL1
WTA_HTTP_CODE_SEE_OTHER	LITERAL1
WTA_HTTP_CODE_NOT_MODIFIED	LITERAL1
WTA_HTTP_CODE_USE_PROXY	LITERAL1
WTA_HTTP_CODE_TEMPORARY_REDIRECT	LITERAL1
WTA_HTTP_CODE_PERMANENT_REDIRECT	LITERAL1
WTA_HTTP_CODE_BAD_REQUEST	LITERAL1
WTA_HTTP_CODE_UNAUTHORIZED	LITERAL1
WTA_HTTP_CODE_PAYMENT_REQUIRED	LITERAL1
WTA_HTTP_CODE_FORBIDDEN	LITERAL1
WTA_HTTP_CODE_NOT_FOUND	LITERAL1
WTA_HTTP_CODE_METHOD_NOT_ALLOWED	LITERAL1
WTA_HTTP_CODE_NOT_ACCEPTABLE	LITERAL1
WTA_HTTP_CODE_PROXY_AUTHENTICATION_REQUIRED	LITERAL1
WTA_HTTP_CODE_REQUEST_TIMEOUT	LITERAL1
WTA_HTTP_CODE_CONFLICT	LITERAL1
WTA_HTTP_CODE_GONE	LITERAL1
WTA_HTTP_CODE_LENGTH_REQUIRED	LITERAL1
WTA_HTTP_CODE_PRECONDITION_FAILED	LITERAL1
WTA_HTTP_CODE_PAYLOAD_TOO_LARGE	LITERAL1
WTA_HTTP_CODE_URI_TOO_LONG	LITERAL1
WTA_HTTP_CODE_UNSUPPORTED_MEDIA_TYPE	LITERAL1
WTA_HTTP_CODE_RANGE_NOT_SATISFIABLE	LITERAL1
WTA_HTTP_CODE_EXPECTATION_FAILED	LITERAL1
WTA_HTTP_CODE_MISDIRECTED_REQUEST	LITERAL1
WTA_HTTP_CODE_UNPROCESSABLE_ENTITY	LITERAL1
WTA_HTTP_CODE_LOCKED	LITERAL1
WTA_HTTP_CODE_FAILED_DEPENDENCY	LITERAL1
WTA_HTTP_CODE_UPGRADE_REQUIRED	LITERAL1
WTA_HTTP_CODE_PRECONDITION_REQUIRED	LITERAL1
WTA_HTTP_CODE_TOO_MANY_REQUESTS	LITERAL1
WTA_HTTP_CODE_REQUEST_HEADER_FIELDS_TOO_LARGE	LITERAL1
WTA_HTTP_CODE_INTERNAL_SERVER_ERROR	LITERAL1
WTA_HTTP_CODE_NOT_IMPLEMENTED	LITERAL1
WTA_HTTP_CODE_BAD_GATEWAY	LITERAL1
WTA_HTTP_CODE_SERVICE_UNAVAILABLE	LITERAL1
WTA_HTTP_CODE_GATEWAY_TIMEOUT	LITERAL1
WTA_HTTP_CODE_HTTP_VERSION_NOT_SUPPORTED	LITERAL1
WTA_HTTP_CODE_VARIANT_ALSO_NEGOTIATES	LITERAL1
WTA_HTTP_CODE_INSUFFICIENT_STORAGE	LITERAL1
WTA_HTTP_CODE_LOOP_DETECTED	LITERAL1
WTA_HTTP_CODE_NOT_EXTENDED	LITERAL1
WTA_HTTP_CODE_NETWORK_AUTHENTICATION_REQUIRED	LITERAL1